39
20
0 0 0 0 0 0 0 0 0 3 22 22 22 22 22 22 22 22 22 22 22 22 22 22 22 22 22 22 22 22 22 22 22 22 22 22 22 22 22 
0 0 0 0 0 0 0 0 0 32 18 22 22 22 22 19 17 17 17 17 17 17 17 17 17 17 17 18 22 22 22 22 22 22 22 22 22 22 22 
12 0 9 0 0 0 0 0 0 0 0 17 18 19 22 4 0 0 0 0 0 0 0 0 0 0 0 0 17 17 17 17 17 17 17 17 17 18 22 
0 1 21 21 21 2 0 0 11 0 0 0 0 0 18 22 22 22 22 22 22 0 0 0 0 22 0 0 0 0 0 0 0 0 0 0 0 0 22 
21 21 21 6 19 0 0 21 21 0 0 0 0 0 0 17 17 17 17 18 22 22 22 22 22 22 22 22 22 22 22 22 22 22 22 22 4 0 22 
22 22 22 19 0 0 22 22 22 0 0 0 0 0 0 0 0 0 0 0 17 17 17 17 18 22 22 22 22 22 22 22 22 22 22 17 0 0 22 
22 22 19 0 0 22 22 22 22 0 0 0 0 10 0 0 0 0 0 0 0 0 0 0 0 17 17 17 17 17 17 17 17 18 22 0 3 22 22 
22 19 0 0 22 22 22 22 22 0 0 0 23 24 24 25 0 0 0 9 0 0 0 0 0 0 0 0 0 0 0 0 0 3 22 0 0 17 22 
17 0 0 22 22 22 22 22 22 0 32 32 27 27 27 27 27 32 1 21 0 0 0 0 0 0 0 11 0 0 0 0 0 3 22 22 4 0 22 
0 3 22 22 22 22 22 22 22 0 32 32 0 32 32 32 0 0 3 22 0 0 21 0 0 21 21 21 21 0 0 0 0 3 22 17 0 0 22 
0 0 17 18 22 22 22 22 22 0 32 0 32 32 32 32 32 32 3 22 0 0 22 0 0 22 22 22 22 0 0 0 22 22 22 0 3 22 22 
22 0 0 0 18 22 22 22 22 0 32 32 32 32 32 32 32 32 3 22 22 22 22 22 22 22 22 22 19 0 0 22 22 22 22 0 0 17 22 
22 22 22 0 0 17 18 22 22 4 32 32 32 32 32 32 32 32 3 22 17 17 17 17 17 17 17 17 0 0 22 22 22 22 22 22 4 0 22 
22 22 22 22 0 0 0 18 22 4 32 32 32 32 32 32 32 32 3 22 0 0 0 0 0 0 0 0 0 22 22 22 22 22 22 17 0 0 22 
22 22 22 22 22 0 0 3 22 4 0 0 0 0 0 0 0 0 3 22 0 0 0 22 22 22 22 22 22 22 22 22 22 22 22 0 3 22 22 
22 22 22 22 22 22 4 3 22 4 0 0 0 0 0 0 0 0 3 22 0 3 22 22 22 22 22 22 22 22 22 22 22 22 22 0 0 18 22 
22 22 22 22 22 19 0 3 22 4 0 0 0 0 0 0 0 0 3 22 0 0 18 22 22 22 22 22 22 22 22 22 22 22 22 22 4 0 22 
22 0 0 0 0 0 0 22 22 4 0 0 0 0 0 0 0 0 3 22 22 0 0 17 17 17 17 17 17 17 17 17 17 17 17 17 0 0 22 
22 0 0 0 0 0 22 22 22 4 0 0 0 0 0 0 0 0 3 22 22 22 0 0 0 0 0 0 0 0 0 0 0 0 0 0 0 22 22 
22 22 22 22 22 22 22 22 22 4 0 0 0 0 0 0 0 0 3 22 22 22 22 22 22 22 22 22 22 22 22 22 22 22 22 22 22 22 22 
